Pro-Russian Rebel Leader Assassinated in East Ukraine	military
EU to recommend abolishing daylight saving time 	government
Trump cancels pay raises for federal employees	government
Contradictions Mount As Lawyer For Colorado Climate Suits Undermines Own Case	oil&energy
These Sassy Pyrex Storage Containers Are Perfect For Cooks With A Sense Of Humor 	food
Egypt looks to repatriate bodies of 2 Britons next week	leisure&travel
'Aretha Truly Was One of a Kind': Al Sharpton Shares a Letter from Barack Obama	entertainment
Finding the Balance Between Eastern and Western Medicine: A Conversation with Aviva Romm 	healthcare&biotechnology
Our planet is dyed red: Earth, as you've never seen it before	null
NEW: Canadian, U.S. documents detail PBC teacher's alleged sexual assault of teen at wedding 	education
Artist Ramiro Silva grapples with the isolation of immigration by painting people from his daily commute	arts
September is International Balloon Month	null
Panalpina awarded GDP certification in Bogota	transportation
No Alcohol for the True Believers	null
Veteran pass-rusher Elvis Dumervil retires	sports
Florida Primaries Recap, Housing And Health, Future of Public Transit in Miami-Dade & Art Studio 	null
DAR TV: 11 Pivotal Wrestling TV Shows 	null
Could garlic be the answer to beating antibiotic resistance? 	healthcare&biotechnology
Jason Seamon honored at Mahomet Seymour High School	education
Milby fingerprint analysis complete, next hearing scheduled	null
How Successful People Lead: Taking Your Influence to the Next Level (Unabridged)	evergreen
Serena Williams moves into third round, will take on sister Venus	sports
NCAA clears Michigan State after Nassar, football, basketball inquiry	sports
Middlefield Canadian Income PCC: Net Asset Value(s)	finance
Kunde Malbec – A Smooth and Savory Splurge	food
All-American Rejects chosen for Wartburg College Large Event	entertainment
Kipnis hits 3-run homer, sends Indians past the Twins	sports
Gilat Satellite Networks (GILT) Stock Rating Upgraded by BidaskClub	finance
MLS Week 27 Player Picks: Peeling Back the Curtain	sports
Hendrix's walk leads Trenton to 3-2 win over Reading 	sports
REVEALED: SCIENCE BEHIND WORLD'S LIGHTEST GRAPHENE WATCH	null
Guerin Emig: Taylor Cornelius good in OSU opener, but he must dare to be great 	sports
This ’65 Vette is an 8-second player with a pro stock heart	sports
Dyson on track to build electric cars	automotiveindustry
The Latest: MS-13 gang terrorized California farm town	null
GLOBAL LNG-Asian prices rise for 3rd week, boosted by North Asian demand	finance
Google partners with Indian banks to provide online loans	finance
Bridge Wins 2018 Brandon Hall Group Excellence Award	sports
Coming this weekend	null
Rugby League European Federation appoints two new independent directors 	sports
Laffs from the Hood: Vol. 2	null
Fire burns duplex on Hoopes Avenue 	null
Rachel Notley pulling Alberta from climate plan 	government
New article in Simplifying Complexity series -- Iterate and increment on content following an agile approach	null
10 Running Routes In NYC That Are Pretty & Don't Smell	null
Trump cancels pay raise federal workers were due in January 	government
Trump allies raise alarm as team of legal advisers shrinks 	government
Lanes closed on I-75 after dump truck overturns	null
Why those under 35 are screwed 	evergreen
Cardinals bring back RB Darius Victor	sports
Onimusha Remaster Will Release On PS4, Xbox One, Nintendo Switch, And PC	videogame
Trump Foundation lawyer asks judge to dismiss lawsuit 	government
Cummins Inc. (CMI) Holdings Reduced by Barings LLC	finance
Serena Williams Wore A Tutu On The Tennis Court And People Loved It 	sports
Mutual of America Capital Management LLC Invests $3.10 Million in Ollie’s Bargain Outlet Holdings Inc (OLLI) Stock	finance
Turang, Ward lead the way for Helena 	sports
Room Request! The Retreat at Blue Lagoon Iceland	retail
County to Honor Contributions of Hispanic Veterans	non-profit&civilorganization
McCartney kicks off 2019 U.S. tour in Raleigh	arts
Kochs unveil list of backed House candidates	government
L&N Painters	null
Rauner Signs Harvest Season Truck Permit Bill	government
How good of a defender could Dillon Brooks be?	sports
Mollie Tibbetts investigation: Aunt pushes back against 'racist, false narrative'	null
Viewpoint: Medicare For All – Too costly or worth the risk? 	healthcare&biotechnology
This Week's PS4, Xbox One, Switch Deals At GameStop In The US	null
A 'sell-by' date for employees? Ageism and rethinking retirement 	finance
Every Self-Respecting Professional Should Know These 4 Business-Critical Calculations 	evergreen
How caddying is helping US students pay their way through college	education
Publix Premium Ground Coffee – As Low As $2.75	null
U.S. weekly rail traffic up 3.9 percent	transportation
Google clarifies location-tracking policy 	informationtechnology
Crossrail project has faced concerns over schedule, funding and safety 	construction
What Time Does the Stock Market Open and Close Globally?	finance
Gilas Pilipinas vs. Syria: Time, Live Stream for 2018 Asian Games	sports
St. Louis prosecutor lists 28 officers on 'exclusion list'	government
SUNSHINE SHOWDOWN: Florida Governor’s Race Pits Bernie’s Candidate VS Trump’s Pick	government
Penn State Football: KJ Hamler’s speed headlines starting role	sports
MARKETS: Ulta is a Kardashian story, Lululemon is an e-commerce story	retail
The Latest: Ohio State trustee chair backs Meyer process 	sports
Kramer Hickok leads Web.com Tour Finals event 	sports
Europe And Asia Pacific Carbon Emissions Trading Market 2017-2024 Featuring EEX Group, Intercontinental Exchange, Inc, Korea Exchange & OMF	finance
Paragraph 2 of the Beijing Platform for Action, Chapter I: Mission Statement	non-profit&civilorganization
Formula E links up with best young minds in art and design to create new trophies 	automotiveindustry
ForexLive European FX news wrap: Markets rock back and forth on the risk swing	finance
Giuliani preps report to rebut potential Mueller findings	government
Jew-ish: The Gray Area of Being a Modern Jew	non-profit&civilorganization
Researcher admits plot to steal GSK secrets to sell in China	healthcare&biotechnology
Chicken Salad Chick To Make Debut In Hattiesburg	food
Tesla Designs Wireless Charger 	informationtechnology
Victim's family calls ex-cop's 15-year sentence too short	legal
Mycoplasma bovis confirmed in Northland district	agriculture
Indy IPL Building To Light Up During Stand Up To Cancer Telecast 	arts
The Latest: Trump says Russia probe no factor in McGahn exit 	government
What It's Like to Wish You'd 'Never Been Born' 	null
Lil Scrappy’s Mother Momma Dee and Her Husband Ernest Join Another Reality Show Amid Marital Issues	entertainment
Today Would Have Been Michael Jackson’s 60th Birthday – How Is He Remembered? | Megyn Kelly TODAY 	entertainment
‘The Code’: Luke Mitchell To Headline New CBS Drama Series After Recasting 	entertainment
Grandmaster Richard Pask pens book on the art of checkers 	sports
Bank of America is making an important change to trading on retirement accounts	finance
TVC Pro Driver Program Saves Careers and Assets of Truckers 	transportation
CNN stands by story about whether Trump knew of meeting	media
A 20-Hour Direct Flight Will Be Available in the Near Future	airline
Deputy: Florida boy threatened to ‘blow up’ another student	education
$100 million funding rounds create frenzy around tech startups 	informationtechnology
‘Sons of Anarchy’ Spinoff ‘Mayans M.C.’ Will Address Immigration Issues	entertainment
Emerald Health Therapeutics Reports 2nd Quarter 2018 Financial Results and Provides Corporate Update	healthcare&biotechnology
Guilty plea in threats made to family of FCC chairman	null
Amber Alert issued in Indiana for three Michigan children 	null
Illinois aims $108M VW settlement to replace diesel engines	automotiveindustry
Origins of Every Super Smash Bros. Ultimate Stage	videogame
Oklahoma County jail inmate dies in cell	null
WOMAN'S FINGERS "DECAPITATED" IN SURFING INCIDENT. HILLARY CLINTON TO BLAME?	null
At least 7 dead after Greyhound bus, semitrailer collide head-on	null
'Grandpa Scam' Foiled Thanks To Bank Teller	finance
Oil Hits Fresh Multi-Week Highs	oil&energy
Stoughton Army Navy store will reopen this Saturday	retail
Choice in a Man’s Life: Probability or Possibility	evergreen
Democrats attack Trump 24/7. Ideas for moving the country forward?	government
A look at chef Barbara Lynch's restaurant empire	food
VIDEO: Ariana Grande Sings "Natural Woman" at Aretha Franklin's Funeral 	entertainment
Construction Partners (ROAD) Stock Rating Upgraded by Zacks Investment Research	finance
This 'Breaking Bad' Candy Shaped Like the Show's Blue Meth Is a Really Bad Idea 	manufacture
Terms of Service Violation	null
Washington comes together for McCain, with one exception 	government
In 1993, Grays Harbor attractions received lots of publicity	null
Aretha Franklin Funeral: Details of Service, Including Superstar Guest List, Revealed	entertainment
Jorma Kaukonen says he shares stories that "touched me profoundly" in his new memoir, "Been So Long"	entertainment
No. 6 Washington heads South to face No. 9 Auburn	sports
Brain Computer Interface (BCI) Market Demand, Growth, Opportunities and Analysis Of Top Key Player Forecast To 2025	informationtechnology
2013+ Ram 1500 Chrome Grille 	videogame
Questions regarding the DMV debacle 	government
Woman in deadly crash had brakes cut for crack pipe, police say	automotiveindustry
Memories of Christopher Creek life 	null
Burn the Point draws a crowd on a cool summer night in Billings 	automotiveindustry
Bloomberg	null
Analysis: What's lost when the president can't show up?	government
11 Popular Attractions and Their Less Crowded Alternatives	null
Microsoft to contractors: Give new parents paid leave	informationtechnology
Former Medical Examiner Traded Opioids For Sex 	healthcare&biotechnology
Community Calendar	null
Yara Shahidi Announces #WeVoteNext Summit to Educate Youth Leaders	education
New Port Richey 	null
Inside the Chaotic World of Whale Shark Tourism	null
Auction: 15016965	null
Swedish study notes surge in Twitter bots ahead of election	informationtechnology
Windsor man arrested after downtown robbery 	null
'For Motion Picture Use Only': Police advise North Dakota community about rash of counterfeit money	null
SC quashes FIR against Malayalam actress Priya Varrier	legal
Final farewells to Sen. John McCain begin at Arizona Capitol	government
Scientists Observe Decay of Higgs Boson Particle into Two Bottom Quarks	research
Box Inc (BOX) to Post Q4 2019 Earnings of $0.01 Per Share, First Analysis Forecasts	informationtechnology
Musical Ride-bred horses slated for largest-ever RCMP Foundation auction 	null
Three Bulgarian ministers quit over fatal bus crash 	null
White Plains real estate developer accused of fraud	null
FORECAST | Toasty Tuesday	null
A 47-year-old man was fatally stabbed early Wednesday near the Union Pacific Railroad building in North Little Rock, police said. 	null
F&M political poll results: High interest in midterm election 	government
UPDATE - Flexpoint Sensor Systems, Inc. Receives Significant Purchase Order from Manus VR	informationtechnology
The Latest: Meyer did not tell OSU about '09 allegations	sports
Database company wins millions in lawsuit against founder 	informationtechnology
Wakefield Design Center Accessories 	null
Shakespeare, Cooking: Upcoming Events On The Westborough Calendar 	null
7 dead, dozens injured after Greyhound bus and truck collide in New Mexico	transportation
Blake Lively Brings Mom as Her Date to 2018 MTV Video Music Awards 	entertainment
Purged NATO officer speaks out after escaping jail in Turkey 	government
Beverly Hills, 90210 Re-Traumatizes Val	entertainment
DeKalb, Atlanta schools annexation fight spills into second court case	education
Genetics and Pollution Drive Severity of Asthma Symptoms	healthcare&biotechnology
Southern Nash dominates Bunn, 55-14	sports
Adaptation of Nick Hornby’s ‘Juliet, Naked’ hits mostly right notes | Movie review	entertainment
Great Lakes Cruises Being Explored	transportation
Urban Meyer's fate will be debated by Ohio State Board of Trustees on Wednesday	government
20 Facts You Learned in School That Are No Longer True 	evergreen
The Future Of Agency Models	null
Black bear hit by arrow mauls hunter before dying, reports say	null
Secret Service Pays Tribute to John McCain with His Code Name: 'Phoenix - May you Rest In Peace'	government
Why Email is the Key to Aligning Sales and Marketing	evergreen
John Dean of Nixon fame to testify at Kavanaugh hearing 	government
Hulkenberg changing his mind about F1 halo after crash	null
The Power of "Avinu Malkeinu"	null
LCCC Dental Health Advisory Committee holds bi-annual meeting	healthcare&biotechnology
Dyson plans test track for electric cars at Wiltshire airfield base 	automotiveindustry
Spinal Devices Market to Witness Comprehensive Growth by 2026	healthcare&biotechnology
Correction: Hiring Ex-Prisoners story 	legal
I’m in the USA and I’ve heard people from the UK talking about crumpets. Are they the same as pancakes? What toppings do you use?	food
Sweden's Granges halts plans for U.S. aluminum joint venture 	manufacture
Perez in pink on top for Force India in wet opening practice	sports
MacIver News Minute: How School Districts Use Act 10 to Save Billions on Health Insurance	education
United States to Terminate UNRWA Funding	non-profit&civilorganization
How Well Do You Remember Breaking Bad? Test Your Crystal Blue Knowledge Now!	null
The Latest: Terror studied as possible motive for stabbings	null
KJZZ News 	null
Business Lawyer, Flaster Greenberg Of Counsel Marc Garber Dies at Age 67	finance
Never Forget About the Donkey Kong Country Cartoon	animation
Campbell Soup to Sell Its International, Fresh Food Businesses 	food
Pyramidion Technology Group, Inc. (OTC: PYTG) Appoints New Scientific Advisory Board Team to Support Company Strategy in the Medical CBD Industry	healthcare&biotechnology
Video: Friggin' Rights - One Month on Canadian Shores	entertainment
Director Gavras slams 'bad taste' joke after hoaxer tweets his 'death' 	entertainment
4 Things Successful People Do in the Last 15 Minutes of Their Workday	evergreen
Alec Baldwin On Career Highs And Lows And Playing A 'Larger Than Life' Trump	null
Brief: Library introduces new literacy-math program 	education
Kerry Logistics’ profits grow by double digits in H1 2018	transportation
Dutch anti-Islam lawmaker cancels Prophet cartoon contest	legal
Blue Angels to Receive "Super Hornet" Upgrade 	airline
The Latest: Aretha Franklin's body arrives at Detroit church 	entertainment
METH AND MARIJUANA CHARGES FOR DRIVER AND 2 PASSENGERS, GPD MAKE ARREST	transportation
Oregon hunter rescued after hanging upside down in tree for 2 days	null
2 burned by angry mob in central Mexico	null
Hilary Duff 'laughs off' critics 	entertainment
Pflugerville officer's daughter with rare blood disease in desperate need of bone marrow donor 	healthcare&biotechnology
Businesswoman arrested with two infants	null
Health care cost measure is a mess in Livermore 	healthcare&biotechnology
Leaves changing color early could mean big problems 	null
Washingtonian Today: To Air Is Humid	null
The next iPhones, Apple Watch leak as company preps for Sept. 12 event	manufacture
Mark Ronson shares Michael Jackson mash-up song 'Diamonds are Invincible'	entertainment
Vinings Village Civic Club hosting meeting on road project plans 	non-profit&civilorganization
Pumpkin Spice Protein Breakfast Cookie	food
Accentuate the positive, eliminate the negative	evergreen
Cannabis extract could form basis of new anti-psychotic treatments	healthcare&biotechnology
Broadway Friends and Family Remember Neil Simon: ‘We Will Not See His Like Again’ 	entertainment
‘Fortnite’ Patch 5.21 Brings in a New Heavy Sniper Rifle and the Soaring 50’s Limited Time Mode for Battle Royale	videogame
The Big Picture	null
Pedestrian Killed By Light Rail Train: Denver Police 	transportation
When Priyanka's ex-boyfriend Aseem Merchant wanted to make biopic on her 	entertainment
South Tahoe man may have drowned retrieving model airplane	null
Decolati, Golsan and Stovall lead Grand Junction in win 	sports
Heritage Farmstead Museum to host volunteer information fair on September 12	arts
Trump stumps for Braun	government
Ford cancels plan to import Focus crossover from China, blames trade war 	automotiveindustry
How to Make Your Hair Grow Faster	null
Gin taster wanted: Company will hire you to travel the world, drink with friends	food
Jason Isbell, Jack Johnson and The Smashing Pumpkins kick off a week of top Utah concerts 	null
Roslindale Square to get low-key tattoo parlor 	null
'Hellpoint' (ALL) Announced - Screens & Trailer	videogame
Watch The New First Man Trailer: The Most Dangerous Mission In History	entertainment
Woman arrested after killing two people in 2017 three-vehicle crash	null
Boll Medical alleged to owe more than $350,000 to Pennsylvania company 	healthcare&biotechnology
See what the IHS Markit Score report has to say about Edwards Lifesciences Corp.	healthcare&biotechnology
Scott has chance to flip senate seat to GOP	government
Amobee Closes Videology Deal As The Duo Chart A Course To Take On Advanced TV	entertainment
Laurel tries to give 5th-graders a leg up when they start middle school. Here's how. 	education
‘Hard love’ NJ teacher who called kids ‘ugly’ returns to work — with less pay	non-profit&civilorganization
Taylor Swift pays tribute to Aretha Franklin at Detroit show	entertainment
London's Gatwick airport says runway open again after brief closure	airline
Family Fun Friday supplies local kids with fun and backpacks	non-profit&civilorganization
White Denim's Steve Terebecki Plays Favorites with the Band's Six Albums	entertainment
Area fast food workers rally for higher wages, union rights	food
Turkish lira further weakens, nearing record low	finance
All aboard!	null
‘It should be ours’: Comm Games’ $35m windfall 	videogame
PHOTOS: Lincoln vs. Bainbridge, Week 2 high school football	sports
Hospital staff question officials after 2nd attack in a week	null
Matt Groening thought Michael Jackson call was a prank 	entertainment
United Airlines adds Prague and Naples, Italy	airline
Equipment stolen from Cooper's Hawk Winery: Orange Police Blotter	null
Mob Protests in Chemnitz Show New Strength of Germany’s Far Right	null
Wife Of Israeli Prime Minister Benjamin Netanyahu Suspected Of Bribery	government
Ronan Farrow’s Ex-Producer Says NBC Impeded Weinstein Reporting	entertainment
15 aboard Hawaii flight treated after pepper spray goes off 	airline
Movie Menu: Pretty Woman, The Godfather, Pillow Talk and more	entertainment
DowntownersAssociationdebutedtheLunchPad	food
BALDWIN Vision Systems to Unwrap the Secret to Accurate Color Reproduction at Packaging Innovations 2018	manufacture
CERN scientists have witnessed the decay of the Higgs boson particle 	research
Jennifer Lawrence Wore the Chicest "Lift and Tuck" Leggings	fashion
Air leaking from Russian side of International Space Station	airline
Dancing butter? 	null
Tianjin Airlines connects Heathrow with Chongqing	airline
CAR-T Therapies Market, 2018-2030 - Review and Quantify Future Opportunities - ResearchAndMarkets.com	finance
FAST FIVE: "Sloppy" Carl Bernstein Hits Back At Trump: "I Stand By My Reporting" 	government
The Rise of Resurrection Biology	null
Roof of 16th century church collapses in Roman Forum 	null
Against Identity Politics	null
All In the name ‘Kiki dance challenge’ pilot jumps out of a moving plane (Video)	fashion
Flooding could impact weekend travel	null
Michael Jackson’s Family Celebrate 60th Birthday In Las Vegas With Usher & More	entertainment
UPDATE 1-U.S. crude production rises to record as drilling climbs in Texas - EIA	oil&energy
Review: Donnie Yen’s ‘Big Brother’ is one dimensional	entertainment
EU will respond in kind if U.S. imposes car tariffs: Juncker	automotiveindustry
Why iss the telephoto lense sticking. It works well on occasions.	null
Ethiopia: Helicopter Crash Leaves 18 Dead	airline
Time to Buy BancFirst Corporation (BANF) After The Completion of This Double Top?	finance
Prince Harry sings a few lines of 'Hamilton' with Meghan and Lin-Manuel Miranda	entertainment
Logged off: Some teens refuse to use social media	evergreen
Tales of Berseria Review	videogame
19 of the best job perks and benefits millennials have that their parents didn't	evergreen
Protect Transgender People From Workplace Discrimination	non-profit&civilorganization
Dragalia Lost, Nintendo’s Upcoming RPG for Mobiles, Gets Detailed in Short Direct Video	videogame
The Italian island that only welcomes visitors twice a year opens today	airline
I demand to know which Mods are deleting my posts.	null
Philippines Informs China of Grounded Frigate Amid Sea Feud 	maritime
7 reasons why your UAE visa application may be rejected 	evergreen
Great Northern Theatre Company To Hold Auditions For Fall Production 	entertainment
15 TV Shows You Should Binge-Watch This September	entertainment
Peyton Manning re-tells story behind hitting kids in the face in 'SNL' spoof	non-profit&civilorganization
Astronauts on International Space Station fix leak ahead of Labor Day weekend	null
Hungry Dragon flies onto iOS and Android	videogame
Tony-nominated actor Adam Pascal to lead master class at the Box Theatre in Oconomowoc	arts
Eight Hurt in Chicago Water Plant Blast 	null
Trump Falsely Accuses NBC's Lester Holt Of Getting 'Caught Fudging' Russia Interview	government
Insider Selling: Skyline Co. (SKY) EVP Sells 31,725 Shares of Stock	finance
Connections made, why I love The News	null
LA is getting Obama Boulevard—but what happened to Obama Highway?	non-profit&civilorganization
BRICKLAYERS & ALLIED CRAFTWORKERS LOCAL NO. 3, NEW YORK, AFL-CIO v. PRECISION CONCRETE AND MASONRY, INC. 	null
ICE Called A Terrorist Organization	government
‘Black Panther’ star Chadwick Boseman says Marvel wasn’t initially sold on T’Challa’s African accent	entertainment
The Latest: Man charged with Globe threats was loud neighbor 	null
Nepal and India agree to survey cross-border rail 	transportation
At least 10 killed in South Africa bus crash	transportation
South Deerfield water district grapples with violations, turbidity	null
He got dumped, then quit his job. Now, at age 33, a baseball-loving British man has finally found his purpose.	evergreen
HRT receives grant to purchase battery-powered electric buses	transportation
Global Veal Meat Market 2018-2022 | New Veal Processing and Packaging Technology to Boost Growth | Technavio	manufacture
Dutch police shoot suspect after stabbing at train station 	null
UD president says these areas of technology are becoming critical 	null
Top 20 Global Concert Tours from Pollstar 	arts
Watch Little Nana Iris' naughty twist on the baby shark dance which has sent Facebook into meltdown	null
Restoration work on Capitol building nears completion	construction
Drive on to attract cruise ships to Great Lakes	transportation
Woman involved in crash with pig hauler now in fair condition	null
Global Steel Production Up as China Churns Out Record Output	manufacture
Man charged with making threats to Boston Globe, calling paper 'enemy of the people' 	null
The Art and Science of Synthesist David Burraston	arts
Tips for Using Pinterest for Social Marketing	evergreen
Mwilu back to work, attends JSC meeting	government
Finding Happiness	evergreen
Six Flags is adding its 17th roller coaster, and it will break three records 	manufacture
10 Things to Know for Today	evergreen
How long should #MeToo purgatory last? 	null
The Four Keys to Mindful Parenting	evergreen
Exhibition at Museum Ludwig presents photographs from Diane Arbus to Piet Zwart	arts
WEST SIDE STORY Comes to Town Theatre	arts
Global Furniture Market 2018 by Manufacturers, Regions, Type and Application, Forecast to 2023	manufacture
Kevin Spacey deserves a second chance, says former 'House of Cards' co-star Robin Wright	arts
Tropical Wave Could Mean A Wet & Windy Holiday Weekend For South Florida	null
Packaging Tubes Market in-Depth Analysis with Booming Trends Analyzed for the Period 2018-2028	manufacture
Great White Washes Up on Beach Near Where SUNY Professor Was Attacked by Shark	null
GeForce RTX 2080 3DMark Time Spy Benchmark Leak Approaches Titan Xp Performance 	manufacture
Authorities identify mystery woman in Texas doorbell video	null
5 Personality Traits Happy People Share, According to Science	evergreen
Add 256GB of SanDisk USB 3.0 Flash Storage to your backpack for $50 via Amazon	null
Hurricane Lane Adds to a Wet Year for Big Island Farmers 	null
Who Are You? Two Strategies Strong Leaders Use To Define Their Purpose	evergreen
STLV Interviews: Part 2!	null
John Stickley, Mentor, a Siemens Business	evergreen
GREAT AGAIN: American Workers Report ‘HIGHEST JOB SATISFACTION’ Since 2005	non-profit&civilorganization
£600,000 to improve these six toilet blocks in Norfolk 	construction
‘A national shame’: B.C. business groups slam ruling quashing Trans Mountain pipeline 	construction
US-Mexico 'Action Plan' Thinks Big, but Impact May Be Small 	government
Ruling: Watertown Golf Club Sale Can Continue...For Now	null
Kiewit Employee Honored in Constructech’s 2018 Women in Construction 	construction
Florida Roofing Company Faces Penalties For Exposing Employees to Fall and Other Safety Hazards	construction
VOLLEYBALL: Pair of late rallies push Dragons past Kays 	sports
China probably underreporting swine fever: U.S. Agriculture's Perdue	agriculture
Norfolk Mother Won’t be Victimized by Rare Illness.	null
New tariffs on building materials have owners revising construction contracts	construction
Jacobs announces funding for Buffalo & Erie County Public Libraries	construction
PennEnergy Resources to Acquire the Assets of Rex Energy 	construction
Cosmodyne chosen for multiple liquefaction projects	construction
The 'Real Names' of Your Favorite Rappers Are Revealed by This Ridiculous Meme	null
