Pro Russian Rebel Leader Assassinated in East Ukraine	military
EU to recommend abolishing daylight saving time	airline
Trump cancels pay raises for federal employees	finance
Contradictions Mount As Lawyer For Colorado Climate Suits Undermines Own Case	oil&energy
These Sassy Pyrex Storage Containers Are Perfect For Cooks With A Sense Of Humor	null
Egypt looks to repatriate bodies of Britons next week	leisure&travel
Aretha Truly Was One of a Kind Al Sharpton Shares a Letter from Barack Obama	entertainment
Finding the Balance Between Eastern and Western Medicine A Conversation with Aviva Romm	evergreen
Our planet is dyed red Earth as you ve never seen it before	null
NEW Canadian U S documents detail PBC teacher is alleged sexual assault of teen at wedding	education
Artist Ramiro Silva grapples with the isolation of immigration by painting people from his daily commute	arts
September is International Balloon Month	null
Panalpina awarded GDP certification in Bogota	transportation
No Alcohol for the True Believers	null
Veteran pass rusher Elvis Dumervil retires	sports
Florida Primaries Recap Housing And Health Future of Public Transit in Miami Dade Art Studio	null
DAR TV Pivotal Wrestling TV Shows	null
Could garlic be the answer to beating antibiotic resistance	construction
Jason Seamon honored at Mahomet Seymour High School	education
Milby fingerprint analysis complete next hearing scheduled	null
How Successful People Lead Taking Your Influence to the Next Level Unabridged	evergreen
Serena Williams moves into third round will take on sister Venus	sports
NCAA clears Michigan State after Nassar football basketball inquiry	sports
Middlefield Canadian Income PCC Net Asset Value s	finance
Kunde Malbec A Smooth and Savory Splurge	food
All American Rejects chosen for Wartburg College Large Event	entertainment
Kipnis hits run homer sends Indians past the Twins	sports
Gilat Satellite Networks GILT Stock Rating Upgraded by BidaskClub	finance
MLS Week Player Picks Peeling Back the Curtain	sports
Hendrix is walk leads Trenton to win over Reading	sports
REVEALED SCIENCE BEHIND WORLD S LIGHTEST GRAPHENE WATCH	null
Guerin Emig Taylor Cornelius good in OSU opener but he must dare to be great	null
This Vette is an second player with a pro stock heart	sports
Dyson on track to build electric cars	automotiveindustry
The Latest MS gang terrorized California farm town	null
GLOBAL LNG Asian prices rise for rd week boosted by North Asian demand	finance
Google partners with Indian banks to provide online loans	finance
Bridge Wins Brandon Hall Group Excellence Award	sports
Coming this weekend	null
Rugby League European Federation appoints two new independent directors	sports
Laffs from the Hood Vol	null
Fire burns duplex on Hoopes Avenue	healthcare&biotechnology
Rachel Notley pulling Alberta from climate plan	government
New article in Simplifying Complexity series Iterate and increment on content following an agile approach	null
Running Routes In NYC That Are Pretty Don t Smell	null
Trump cancels pay raise federal workers were due in January	government
Trump allies raise alarm as team of legal advisers shrinks	null
Lanes closed on I after dump truck overturns	null
Why those under are screwed	evergreen
Cardinals bring back RB Darius Victor	sports
Onimusha Remaster Will Release On PS Xbox One Nintendo Switch And PC	videogame
Trump Foundation lawyer asks judge to dismiss lawsuit	government
Cummins Inc CMI Holdings Reduced by Barings LLC	finance
Serena Williams Wore A Tutu On The Tennis Court And People Loved It	sports
Mutual of America Capital Management LLC Invests Million in Ollie is Bargain Outlet Holdings Inc OLLI Stock	finance
Turang Ward lead the way for Helena	government
Room Request The Retreat at Blue Lagoon Iceland	retail
County to Honor Contributions of Hispanic Veterans	non-profit&civilorganization
McCartney kicks off U S tour in Raleigh	arts
Kochs unveil list of backed House candidates	government
L N Painters	null
Rauner Signs Harvest Season Truck Permit Bill	government
How good of a defender could Dillon Brooks be	sports
Mollie Tibbetts investigation Aunt pushes back against racist false narrative	null
Viewpoint Medicare For All Too costly or worth the risk	healthcare&biotechnology
This Week is PS Xbox One Switch Deals At GameStop In The US	null
A isell by date for employees Ageism and rethinking retirement	food
Every Self Respecting Professional Should Know These Business Critical Calculations	evergreen
How caddying is helping US students pay their way through college	education
Publix Premium Ground Coffee As Low As	null
U S weekly rail traffic up percent	transportation
Google clarifies location tracking policy	manufacture
Crossrail project has faced concerns over schedule funding and safety	non-profit&civilorganization
What Time Does the Stock Market Open and Close Globally	finance
Gilas Pilipinas vs Syria Time Live Stream for Asian Games	sports
St Louis prosecutor lists officers on exclusion list	government
SUNSHINE SHOWDOWN Florida Governor is Race Pits Bernie is Candidate VS Trump is Pick	government
Penn State Football KJ Hamler is speed headlines starting role	sports
MARKETS Ulta is a Kardashian story Lululemon is an e commerce story	retail
The Latest Ohio State trustee chair backs Meyer process	null
Kramer Hickok leads Web com Tour Finals event	government
Europe And Asia Pacific Carbon Emissions Trading Market Featuring EEX Group Intercontinental Exchange Inc Korea Exchange OMF	finance
Paragraph of the Beijing Platform for Action Chapter I Mission Statement	non-profit&civilorganization
Formula E links up with best young minds in art and design to create new trophies	healthcare&biotechnology
ForexLive European FX news wrap Markets rock back and forth on the risk swing	finance
Giuliani preps report to rebut potential Mueller findings	government
Jew ish The Gray Area of Being a Modern Jew	non-profit&civilorganization
Researcher admits plot to steal GSK secrets to sell in China	healthcare&biotechnology
Chicken Salad Chick To Make Debut In Hattiesburg	food
Tesla Designs Wireless Charger	informationtechnology
Victim is family calls ex cop is year sentence too short	legal
Mycoplasma bovis confirmed in Northland district	agriculture
Indy IPL Building To Light Up During Stand Up To Cancer Telecast	null
The Latest Trump says Russia probe no factor in McGahn exit	null
What It is Like to Wish You d Never Been Born	arts
Lil Scrappy is Mother Momma Dee and Her Husband Ernest Join Another Reality Show Amid Marital Issues	entertainment
Today Would Have Been Michael Jackson is th Birthday How Is He Remembered Megyn Kelly TODAY	entertainment
The Code Luke Mitchell To Headline New CBS Drama Series After Recasting	entertainment
Grandmaster Richard Pask pens book on the art of checkers	finance
Bank of America is making an important change to trading on retirement accounts	finance
TVC Pro Driver Program Saves Careers and Assets of Truckers	finance
CNN stands by story about whether Trump knew of meeting	media
A Hour Direct Flight Will Be Available in the Near Future	airline
Deputy Florida boy threatened to blow up another student	education
million funding rounds create frenzy around tech startups	informationtechnology
Sons of Anarchy Spinoff Mayans M C Will Address Immigration Issues	entertainment
Emerald Health Therapeutics Reports nd Quarter Financial Results and Provides Corporate Update	healthcare&biotechnology
Guilty plea in threats made to family of FCC chairman	null
Amber Alert issued in Indiana for three Michigan children	entertainment
Illinois aims M VW settlement to replace diesel engines	automotiveindustry
Origins of Every Super Smash Bros Ultimate Stage	videogame
Oklahoma County jail inmate dies in cell	null
WOMAN S FINGERS DECAPITATED IN SURFING INCIDENT HILLARY CLINTON TO BLAME	null
At least dead after Greyhound bus semitrailer collide head on	null
Grandpa Scam Foiled Thanks To Bank Teller	finance
Oil Hits Fresh Multi Week Highs	oil&energy
Stoughton Army Navy store will reopen this Saturday	retail
Choice in a Man is Life Probability or Possibility	evergreen
Democrats attack Trump Ideas for moving the country forward	government
A look at chef Barbara Lynch is restaurant empire	food
VIDEO Ariana Grande Sings Natural Woman at Aretha Franklin is Funeral	legal
Construction Partners ROAD Stock Rating Upgraded by Zacks Investment Research	finance
This Breaking Bad Candy Shaped Like the Show is Blue Meth Is a Really Bad Idea	sports
Terms of Service Violation	null
Washington comes together for McCain with one exception	null
In Grays Harbor attractions received lots of publicity	null
Aretha Franklin Funeral Details of Service Including Superstar Guest List Revealed	entertainment
Jorma Kaukonen says he shares stories that touched me profoundly in his new memoir Been So Long	entertainment
No Washington heads South to face No Auburn	sports
Brain Computer Interface BCI Market Demand Growth Opportunities and Analysis Of Top Key Player Forecast To	informationtechnology
Ram Chrome Grille	evergreen
Questions regarding the DMV debacle	healthcare&biotechnology
Woman in deadly crash had brakes cut for crack pipe police say	automotiveindustry
Memories of Christopher Creek life	arts
Burn the Point draws a crowd on a cool summer night in Billings	entertainment
Bloomberg	null
Analysis What is lost when the president can t show up	government
Popular Attractions and Their Less Crowded Alternatives	null
Microsoft to contractors Give new parents paid leave	informationtechnology
Former Medical Examiner Traded Opioids For Sex	healthcare&biotechnology
Community Calendar	null
Yara Shahidi Announces WeVoteNext Summit to Educate Youth Leaders	education
New Port Richey	null
Inside the Chaotic World of Whale Shark Tourism	null
Auction	null
Swedish study notes surge in Twitter bots ahead of election	informationtechnology
Windsor man arrested after downtown robbery	government
For Motion Picture Use Only Police advise North Dakota community about rash of counterfeit money	null
SC quashes FIR against Malayalam actress Priya Varrier	legal
Final farewells to Sen John McCain begin at Arizona Capitol	government
Scientists Observe Decay of Higgs Boson Particle into Two Bottom Quarks	research
Box Inc BOX to Post Q Earnings of Per Share First Analysis Forecasts	informationtechnology
Musical Ride bred horses slated for largest ever RCMP Foundation auction	entertainment
Three Bulgarian ministers quit over fatal bus crash	null
White Plains real estate developer accused of fraud	null
FORECAST Toasty Tuesday	null
A year old man was fatally stabbed early Wednesday near the Union Pacific Railroad building in North Little Rock police said	airline
F M political poll results High interest in midterm election	arts
UPDATE Flexpoint Sensor Systems Inc Receives Significant Purchase Order from Manus VR	informationtechnology
The Latest Meyer did not tell OSU about allegations	sports
Database company wins millions in lawsuit against founder	null
Wakefield Design Center Accessories	sports
Shakespeare Cooking Upcoming Events On The Westborough Calendar	sports
dead dozens injured after Greyhound bus and truck collide in New Mexico	transportation
Blake Lively Brings Mom as Her Date to MTV Video Music Awards	null
Purged NATO officer speaks out after escaping jail in Turkey	government
Beverly Hills Re Traumatizes Val	entertainment
DeKalb Atlanta schools annexation fight spills into second court case	education
Genetics and Pollution Drive Severity of Asthma Symptoms	healthcare&biotechnology
Southern Nash dominates Bunn	sports
Adaptation of Nick Hornby is Juliet Naked hits mostly right notes Movie review	entertainment
Great Lakes Cruises Being Explored	transportation
Urban Meyer is fate will be debated by Ohio State Board of Trustees on Wednesday	government
Facts You Learned in School That Are No Longer True	null
The Future Of Agency Models	null
Black bear hit by arrow mauls hunter before dying reports say	null
Secret Service Pays Tribute to John McCain with His Code Name Phoenix May you Rest In Peace	government
Why Email is the Key to Aligning Sales and Marketing	evergreen
John Dean of Nixon fame to testify at Kavanaugh hearing	government
Hulkenberg changing his mind about F halo after crash	null
The Power of Avinu Malkeinu	null
LCCC Dental Health Advisory Committee holds bi annual meeting	healthcare&biotechnology
Dyson plans test track for electric cars at Wiltshire airfield base	automotiveindustry
Spinal Devices Market to Witness Comprehensive Growth by	healthcare&biotechnology
Correction Hiring Ex Prisoners story	oil&energy
I m in the USA and I ve heard people from the UK talking about crumpets Are they the same as pancakes What toppings do you use	food
Sweden is Granges halts plans for U S aluminum joint venture	government
Perez in pink on top for Force India in wet opening practice	sports
MacIver News Minute How School Districts Use Act to Save Billions on Health Insurance	education
United States to Terminate UNRWA Funding	non-profit&civilorganization
How Well Do You Remember Breaking Bad Test Your Crystal Blue Knowledge Now	null
The Latest Terror studied as possible motive for stabbings	null
KJZZ News	sports
Business Lawyer Flaster Greenberg Of Counsel Marc Garber Dies at Age	finance
Never Forget About the Donkey Kong Country Cartoon	animation
Campbell Soup to Sell Its International Fresh Food Businesses	null
Pyramidion Technology Group Inc OTC PYTG Appoints New Scientific Advisory Board Team to Support Company Strategy in the Medical CBD Industry	healthcare&biotechnology
Video Friggin Rights One Month on Canadian Shores	null
Director Gavras slams bad taste joke after hoaxer tweets his death	education
Things Successful People Do in the Last Minutes of Their Workday	evergreen
Alec Baldwin On Career Highs And Lows And Playing A Larger Than Life Trump	null
Brief Library introduces new literacy math program	sports
Kerry Logistics profits grow by double digits in H	transportation
Dutch anti Islam lawmaker cancels Prophet cartoon contest	legal
Blue Angels to Receive Super Hornet Upgrade	null
The Latest Aretha Franklin is body arrives at Detroit church	airline
METH AND MARIJUANA CHARGES FOR DRIVER AND PASSENGERS GPD MAKE ARREST	transportation
Oregon hunter rescued after hanging upside down in tree for days	null
burned by angry mob in central Mexico	null
Hilary Duff laughs off critics	arts
Pflugerville officer is daughter with rare blood disease in desperate need of bone marrow donor	non-profit&civilorganization
Businesswoman arrested with two infants	null
Health care cost measure is a mess in Livermore	evergreen
Leaves changing color early could mean big problems	null
Washingtonian Today To Air Is Humid	null
The next iPhones Apple Watch leak as company preps for Sept event	manufacture
Mark Ronson shares Michael Jackson mash up song Diamonds are Invincible	entertainment
Vinings Village Civic Club hosting meeting on road project plans	healthcare&biotechnology
Pumpkin Spice Protein Breakfast Cookie	null
Accentuate the positive eliminate the negative	evergreen
Cannabis extract could form basis of new anti psychotic treatments	healthcare&biotechnology
Broadway Friends and Family Remember Neil Simon We Will Not See His Like Again	education
Fortnite Patch Brings in a New Heavy Sniper Rifle and the Soaring is Limited Time Mode for Battle Royale	videogame
The Big Picture	null
Pedestrian Killed By Light Rail Train Denver Police	non-profit&civilorganization
When Priyanka is ex boyfriend Aseem Merchant wanted to make biopic on her	finance
South Tahoe man may have drowned retrieving model airplane	null
Decolati Golsan and Stovall lead Grand Junction in win	informationtechnology
Heritage Farmstead Museum to host volunteer information fair on September	arts
Trump stumps for Braun	government
Ford cancels plan to import Focus crossover from China blames trade war	null
How to Make Your Hair Grow Faster	null
Gin taster wanted Company will hire you to travel the world drink with friends	food
Jason Isbell Jack Johnson and The Smashing Pumpkins kick off a week of top Utah concerts	construction
Roslindale Square to get low key tattoo parlor	retail
Hellpoint ALL Announced Screens Trailer	videogame
Watch The New First Man Trailer The Most Dangerous Mission In History	null
Woman arrested after killing two people in three vehicle crash	null
Boll Medical alleged to owe more than to Pennsylvania company	healthcare&biotechnology
See what the IHS Markit Score report has to say about Edwards Lifesciences Corp	healthcare&biotechnology
Scott has chance to flip senate seat to GOP	government
Amobee Closes Videology Deal As The Duo Chart A Course To Take On Advanced TV	entertainment
Laurel tries to give th graders a leg up when they start middle school Here is how	null
Hard love NJ teacher who called kids ugly returns to work with less pay	non-profit&civilorganization
Taylor Swift pays tribute to Aretha Franklin at Detroit show	entertainment
London is Gatwick airport says runway open again after brief closure	airline
Family Fun Friday supplies local kids with fun and backpacks	non-profit&civilorganization
White Denim is Steve Terebecki Plays Favorites with the Band is Six Albums	entertainment
Area fast food workers rally for higher wages union rights	food
Turkish lira further weakens nearing record low	finance
All aboard	null
It should be ours Comm Games m windfall	videogame
PHOTOS Lincoln vs Bainbridge Week high school football	sports
Hospital staff question officials after nd attack in a week	null
Matt Groening thought Michael Jackson call was a prank	retail
United Airlines adds Prague and Naples Italy	airline
Equipment stolen from Cooper is Hawk Winery Orange Police Blotter	null
Mob Protests in Chemnitz Show New Strength of Germany is Far Right	null
Wife Of Israeli Prime Minister Benjamin Netanyahu Suspected Of Bribery	government
Ronan Farrow is Ex Producer Says NBC Impeded Weinstein Reporting	entertainment
aboard Hawaii flight treated after pepper spray goes off	null
Movie Menu Pretty Woman The Godfather Pillow Talk and more	entertainment
DowntownersAssociationdebutedtheLunchPad	food
BALDWIN Vision Systems to Unwrap the Secret to Accurate Color Reproduction at Packaging Innovations	manufacture
CERN scientists have witnessed the decay of the Higgs boson particle	finance
Jennifer Lawrence Wore the Chicest Lift and Tuck Leggings	fashion
Air leaking from Russian side of International Space Station	airline
Dancing butter	finance
Tianjin Airlines connects Heathrow with Chongqing	airline
CAR T Therapies Market Review and Quantify Future Opportunities ResearchAndMarkets com	finance
FAST FIVE Sloppy Carl Bernstein Hits Back At Trump I Stand By My Reporting	government
The Rise of Resurrection Biology	null
Roof of th century church collapses in Roman Forum	entertainment
Against Identity Politics	null
All In the name Kiki dance challenge pilot jumps out of a moving plane Video	fashion
Flooding could impact weekend travel	null
Michael Jackson is Family Celebrate th Birthday In Las Vegas With Usher More	entertainment
UPDATE U S crude production rises to record as drilling climbs in Texas EIA	oil&energy
Review Donnie Yen is Big Brother is one dimensional	arts
EU will respond in kind if U S imposes car tariffs Juncker	automotiveindustry
Why iss the telephoto lense sticking It works well on occasions	null
Ethiopia Helicopter Crash Leaves Dead	airline
Time to Buy BancFirst Corporation BANF After The Completion of This Double Top	finance
Prince Harry sings a few lines of Hamilton with Meghan and Lin Manuel Miranda	entertainment
Logged off Some teens refuse to use social media	evergreen
Tales of Berseria Review	videogame
of the best job perks and benefits millennials have that their parents didn t	evergreen
Protect Transgender People From Workplace Discrimination	non-profit&civilorganization
Dragalia Lost Nintendo is Upcoming RPG for Mobiles Gets Detailed in Short Direct Video	videogame
The Italian island that only welcomes visitors twice a year opens today	airline
I demand to know which Mods are deleting my posts	null
Philippines Informs China of Grounded Frigate Amid Sea Feud	healthcare&biotechnology
reasons why your UAE visa application may be rejected	transportation
Great Northern Theatre Company To Hold Auditions For Fall Production	entertainment
TV Shows You Should Binge Watch This September	entertainment
Peyton Manning re tells story behind hitting kids in the face in SNL spoof	non-profit&civilorganization
Astronauts on International Space Station fix leak ahead of Labor Day weekend	null
Hungry Dragon flies onto iOS and Android	videogame
Tony nominated actor Adam Pascal to lead master class at the Box Theatre in Oconomowoc	arts
Eight Hurt in Chicago Water Plant Blast	leisure&travel
Trump Falsely Accuses NBC is Lester Holt Of Getting Caught Fudging Russia Interview	government
Insider Selling Skyline Co SKY EVP Sells Shares of Stock	finance
Connections made why I love The News	null
LA is getting Obama Boulevard but what happened to Obama Highway	non-profit&civilorganization
BRICKLAYERS ALLIED CRAFTWORKERS LOCAL NO NEW YORK AFL CIO v PRECISION CONCRETE AND MASONRY INC	informationtechnology
ICE Called A Terrorist Organization	government
Black Panther star Chadwick Boseman says Marvel wasn t initially sold on T Challa is African accent	entertainment
The Latest Man charged with Globe threats was loud neighbor	entertainment
Nepal and India agree to survey cross border rail	sports
At least killed in South Africa bus crash	transportation
South Deerfield water district grapples with violations turbidity	null
He got dumped then quit his job Now at age a baseball loving British man has finally found his purpose	evergreen
HRT receives grant to purchase battery powered electric buses	transportation
Global Veal Meat Market New Veal Processing and Packaging Technology to Boost Growth Technavio	manufacture
Dutch police shoot suspect after stabbing at train station	null
UD president says these areas of technology are becoming critical	transportation
Top Global Concert Tours from Pollstar	arts
Watch Little Nana Iris naughty twist on the baby shark dance which has sent Facebook into meltdown	null
Restoration work on Capitol building nears completion	construction
Drive on to attract cruise ships to Great Lakes	transportation
Woman involved in crash with pig hauler now in fair condition	null
Global Steel Production Up as China Churns Out Record Output	manufacture
Man charged with making threats to Boston Globe calling paper enemy of the people	education
The Art and Science of Synthesist David Burraston	arts
Tips for Using Pinterest for Social Marketing	evergreen
Mwilu back to work attends JSC meeting	government
Finding Happiness	evergreen
Six Flags is adding its th roller coaster and it will break three records	null
Things to Know for Today	evergreen
How long should MeToo purgatory last	sports
The Four Keys to Mindful Parenting	evergreen
Exhibition at Museum Ludwig presents photographs from Diane Arbus to Piet Zwart	arts
WEST SIDE STORY Comes to Town Theatre	arts
Global Furniture Market by Manufacturers Regions Type and Application Forecast to	manufacture
Kevin Spacey deserves a second chance says former House of Cards co star Robin Wright	arts
Tropical Wave Could Mean A Wet Windy Holiday Weekend For South Florida	null
Packaging Tubes Market in Depth Analysis with Booming Trends Analyzed for the Period	manufacture
Great White Washes Up on Beach Near Where SUNY Professor Was Attacked by Shark	null
GeForce RTX DMark Time Spy Benchmark Leak Approaches Titan Xp Performance	manufacture
Authorities identify mystery woman in Texas doorbell video	null
Personality Traits Happy People Share According to Science	evergreen
Add GB of SanDisk USB Flash Storage to your backpack for via Amazon	null
Hurricane Lane Adds to a Wet Year for Big Island Farmers	null
Who Are You Two Strategies Strong Leaders Use To Define Their Purpose	evergreen
STLV Interviews Part	null
John Stickley Mentor a Siemens Business	evergreen
GREAT AGAIN American Workers Report HIGHEST JOB SATISFACTION Since	non-profit&civilorganization
to improve these six toilet blocks in Norfolk	entertainment
A national shame B C business groups slam ruling quashing Trans Mountain pipeline	informationtechnology
US Mexico Action Plan Thinks Big but Impact May Be Small	government
Ruling Watertown Golf Club Sale Can Continue For Now	null
Kiewit Employee Honored in Constructech is Women in Construction	arts
Florida Roofing Company Faces Penalties For Exposing Employees to Fall and Other Safety Hazards	construction
VOLLEYBALL Pair of late rallies push Dragons past Kays	non-profit&civilorganization
China probably underreporting swine fever U S Agriculture is Perdue	agriculture
Norfolk Mother Won t be Victimized by Rare Illness	null
New tariffs on building materials have owners revising construction contracts	construction
Jacobs announces funding for Buffalo Erie County Public Libraries	construction
PennEnergy Resources to Acquire the Assets of Rex Energy	sports
Cosmodyne chosen for multiple liquefaction projects	construction
The Real Names of Your Favorite Rappers Are Revealed by This Ridiculous Meme	null
